1111111
10000P1
1011E01
1C11011
1111111