11111111
11E11111
11111111
1P111111
11111111
11C11111
11111111